*WTF : what the f*** : what's the fuss : why the frown : what true friend : where's the forum : well trained forum : what the f*ck? : well that's fantastic : what the f***! : well that's fantastic : what the frick : well that's fine : wow! that's funky! : what the fudge : where's the food? : where's the f***ing? : why the face : way to funny : what the flip? : want to find : way totally fun : welcome to facebook : well thats fantastic : well, that's funny : what the freak?#
*LOL  : laughing out loud : lots of luck : lots of laughs : little old ladies : laugh out loud : looking on line : looking over liam : lots of love : love on line : love outdated laws : lots of lollygagging : loads of love : love of life : line over line : lack of laughter : land of lincoln : laughing on line : lion on line : love of laughing : love of lord#
*BRB  : be right back  : bathroom break : be ready b*tch : be ready b***h : be real b*tch : be right back
(ayomide) : be ready baby : be right back!#
*BBL  : be back later  : bye-bye loser : baby love#
*ASAP  : adult singles at peace : as soon as possible : as soon as practical#
*B4  : before#
*B4N  : bye for now #
*BTW  : by the way : but that's wild : bye till wednesday : between : be that way#
*L8R  : later #
*tmrw  : tomorrow#
*ETA  : estimated time of arrival#
*F2F  : face to face : fun to f***#
*GF  : good friend : girl friend : globus forum : geometry first : good fight#
*GN  : good night#
*GM  : get me : good morning : good message : gutter mouth : group message : goodness me!#
*BF  : boyfriend : best friends : big fat : bisexual female : bloody fool : boswells forum : big finger : boy friend#
*BFF  : best friends forever : be forever faithful : best feline friend : best friend forever#
*AML  : all my love : animorph mailing list : animal#
*GTG  : got to go : gotta go : gain to grow : glad to go : great to good#
*GR8  : great : great!#
*IDK  : i don't know : i don't know : i don't kill#
*IDC  : international discussion club : i don't care#
*ILY  : i love you : i'm leaving you#
*JK  : just kidding! : juz kiddin : jiminy kricket : joking : joe kool : just kidding#
*LMK  : let me know#
*THX  : thank you : thanks#
*PLS  : please leave the scene#
*TTYL  : talk to you later : the time you learned : type to you later : tell teacher you're loyal : ta ta you all#
*TMI  : too much information#
*CYE #
*FYI  : for your information  : forget your idea : for your innerself : f*** you idiot : f*** yeah information#
*IMHO  : in my humble opinion : in my honest opinion : in my hesitating opinion#
*ROFL  : rolls on floor, laughing : rights of fingering lesbians : rinding on flying llamas : roll/rolling on the floor laughing#
*BION #
*BRT  : be right there#
*PCM  : please call me#
*IYKWIM  : if you know what i mean#
*WYSIWYG  : what you see is what you get#
*XOXO  : hugs and kisses#
*SMD  : s*** my d*** : so much done : solve my dilemma#
